P00##000000
0000000000#
0######000#
00000000#00
#00###0000#
0000###0#0#
#####00000#
0000000T#00
#00#000##0#