P00##0000
000000000
0##0###00
00000000#
#00###000
000000###
###0#0000
0000000T#
#00#000##