P00##000
00000000
0##0###0
00000000
#00###00
000000#0
###0#000
0000000T