P00##0000000#
0000000000#00
0######000##0
00000000#00#0
#00###0000#00
0000###0#0#0#
#####00000#0#
00000000#000#
#00#000##0#T0